instant,season_x,yr_x,weekday_x,workingday_x,windspeed_x,casual_x,registered_x,cnt_x,season_y,yr_y,hr,weekday_y,workingday_y,windspeed_y,casual_y,registered_y,cnt_y
1,1,0,6,0,0.160446,331,654,985,1,0,0,6,0,0.0,3,13,16
2,1,0,0,0,0.248539,131,670,801,1,0,1,6,0,0.0,8,32,40
3,1,0,1,1,0.248309,120,1229,1349,1,0,2,6,0,0.0,5,27,32
4,1,0,2,1,0.160296,108,1454,1562,1,0,3,6,0,0.0,3,10,13
5,1,0,3,1,0.1869,82,1518,1600,1,0,4,6,0,0.0,0,1,1
6,1,0,4,1,0.0895652,88,1518,1606,1,0,5,6,0,0.0896,0,1,1
7,1,0,5,1,0.168726,148,1362,1510,1,0,6,6,0,0.0,2,0,2
8,1,0,6,0,0.266804,68,891,959,1,0,7,6,0,0.0,1,2,3
9,1,0,0,0,0.36195,54,768,822,1,0,8,6,0,0.0,1,7,8
10,1,0,1,1,0.223267,41,1280,1321,1,0,9,6,0,0.0,8,6,14
11,1,0,2,1,0.122132,43,1220,1263,1,0,10,6,0,0.2537,12,24,36
12,1,0,3,1,0.304627,25,1137,1162,1,0,11,6,0,0.2836,26,30,56
13,1,0,4,1,0.301,38,1368,1406,1,0,12,6,0,0.2836,29,55,84
14,1,0,5,1,0.126548,54,1367,1421,1,0,13,6,0,0.2985,47,47,94
15,1,0,6,0,0.157963,222,1026,1248,1,0,14,6,0,0.2836,35,71,106
16,1,0,0,0,0.188433,251,953,1204,1,0,15,6,0,0.2985,40,70,110
17,1,0,1,0,0.194017,117,883,1000,1,0,16,6,0,0.2985,41,52,93
18,1,0,2,1,0.146775,9,674,683,1,0,17,6,0,0.2836,15,52,67
19,1,0,3,1,0.208317,78,1572,1650,1,0,18,6,0,0.2537,9,26,35
20,1,0,4,1,0.195904,83,1844,1927,1,0,19,6,0,0.2537,6,31,37
21,1,0,5,1,0.353242,75,1468,1543,1,0,20,6,0,0.2537,11,25,36
22,1,0,6,0,0.17197,93,888,981,1,0,21,6,0,0.194,3,31,34
23,1,0,0,0,0.2466,150,836,986,1,0,22,6,0,0.2239,11,17,28
24,1,0,1,1,0.15833,86,1330,1416,1,0,23,6,0,0.2985,15,24,39
25,1,0,2,1,0.129796,186,1799,1985,1,0,0,0,0,0.2985,4,13,17
26,1,0,3,1,0.29385,34,472,506,1,0,1,0,0,0.2537,1,16,17
27,1,0,4,1,0.113837,15,416,431,1,0,2,0,0,0.2836,1,8,9
28,1,0,5,1,0.1233,38,1129,1167,1,0,3,0,0,0.194,2,4,6
29,1,0,6,0,0.145365,123,975,1098,1,0,4,0,0,0.194,2,1,3
30,1,0,0,0,0.0739826,140,956,1096,1,0,6,0,0,0.2985,0,2,2
31,1,0,1,1,0.187192,42,1459,1501,1,0,7,0,0,0.194,0,1,1
32,1,0,2,1,0.053213,47,1313,1360,1,0,8,0,0,0.2239,0,8,8
33,1,0,3,1,0.264308,72,1454,1526,1,0,9,0,0,0.2239,1,19,20
34,1,0,4,1,0.277752,61,1489,1550,1,0,10,0,0,0.2239,7,46,53
35,1,0,5,1,0.127839,88,1620,1708,1,0,11,0,0,0.2537,16,54,70
36,1,0,6,0,0.161079,100,905,1005,1,0,12,0,0,0.2985,20,73,93
37,1,0,0,0,0.1418,354,1269,1623,1,0,13,0,0,0.1343,11,64,75
38,1,0,1,1,0.0454083,120,1592,1712,1,0,14,0,0,0.194,4,55,59
39,1,0,2,1,0.36195,64,1466,1530,1,0,15,0,0,0.1642,19,55,74
40,1,0,3,1,0.188839,53,1552,1605,1,0,16,0,0,0.1642,9,67,76
41,1,0,4,1,0.221935,47,1491,1538,1,0,17,0,0,0.194,7,58,65
42,1,0,5,1,0.10855,149,1597,1746,1,0,18,0,0,0.3284,10,43,53
43,1,0,6,0,0.203367,288,1184,1472,1,0,19,0,0,0.4478,1,29,30
44,1,0,0,0,0.260883,397,1192,1589,1,0,20,0,0,0.3582,5,17,22
45,1,0,1,1,0.417908,208,1705,1913,1,0,21,0,0,0.3284,11,20,31
46,1,0,2,1,0.291374,140,1675,1815,1,0,22,0,0,0.2985,0,9,9
47,1,0,3,1,0.251791,218,1897,2115,1,0,23,0,0,0.1642,0,8,8
48,1,0,4,1,0.230104,259,2216,2475,1,0,0,1,1,0.3582,0,5,5
49,1,0,5,1,0.264925,579,2348,2927,1,0,1,1,1,0.4179,0,2,2
50,1,0,6,0,0.507463,532,1103,1635,1,0,4,1,1,0.3881,0,1,1
51,1,0,0,0,0.223235,639,1173,1812,1,0,5,1,1,0.2836,0,3,3
52,1,0,1,0,0.307846,195,912,1107,1,0,6,1,1,0.3881,0,30,30
53,1,0,2,1,0.195683,74,1376,1450,1,0,7,1,1,0.194,1,63,64
54,1,0,3,1,0.094113,139,1778,1917,1,0,8,1,1,0.2836,1,153,154
55,1,0,4,1,0.250496,100,1707,1807,1,0,9,1,1,0.3881,7,81,88
56,1,0,5,1,0.346539,120,1341,1461,1,0,10,1,1,0.2537,11,33,44
57,1,0,6,0,0.186571,424,1545,1969,1,0,11,1,1,0.3284,10,41,51
58,1,0,0,0,0.125248,694,1708,2402,1,0,12,1,1,0.2985,13,48,61
59,1,0,1,1,0.289686,81,1365,1446,1,0,13,1,1,0.2836,8,53,61
60,1,0,2,1,0.216425,137,1714,1851,1,0,14,1,1,0.2836,11,66,77
61,1,0,3,1,0.307833,231,1903,2134,1,0,15,1,1,0.2537,14,58,72
62,1,0,4,1,0.225754,123,1562,1685,1,0,16,1,1,0.2537,9,67,76
63,1,0,5,1,0.203346,214,1730,1944,1,0,17,1,1,0.2239,11,146,157
64,1,0,6,0,0.251871,640,1437,2077,1,0,18,1,1,0.1045,9,148,157
65,1,0,0,0,0.343287,114,491,605,1,0,19,1,1,0.0,8,102,110
66,1,0,1,1,0.341352,244,1628,1872,1,0,20,1,1,0.1045,3,49,52
67,1,0,2,1,0.12065,316,1817,2133,1,0,21,1,1,0.1343,3,49,52
68,1,0,3,1,0.22015,191,1700,1891,1,0,22,1,1,0.1343,0,20,20
69,1,0,4,1,0.261877,46,577,623,1,0,23,1,1,0.1045,1,11,12
70,1,0,5,1,0.23297,247,1730,1977,1,0,0,2,1,0.1045,0,5,5
71,1,0,6,0,0.220775,724,1408,2132,1,0,1,2,1,0.1045,0,2,2
72,1,0,0,0,0.270604,982,1435,2417,1,0,2,2,1,0.1343,0,1,1
73,1,0,1,1,0.136926,359,1687,2046,1,0,4,2,1,0.0896,0,2,2
74,1,0,2,1,0.184309,289,1767,2056,1,0,5,2,1,0.1045,0,4,4
75,1,0,3,1,0.203117,321,1871,2192,1,0,6,2,1,0.1045,0,36,36
76,1,0,4,1,0.209579,424,2320,2744,1,0,7,2,1,0.1343,2,92,94
77,1,0,5,1,0.231017,884,2355,3239,1,0,8,2,1,0.1642,2,177,179
78,1,0,6,0,0.368167,1424,1693,3117,1,0,9,2,1,0.2239,2,98,100
79,1,0,0,0,0.207721,1047,1424,2471,1,0,10,2,1,0.3284,5,37,42
80,2,0,1,1,0.288783,401,1676,2077,1,0,11,2,1,0.2985,7,50,57
81,2,0,2,1,0.22575,460,2243,2703,1,0,12,2,1,0.1642,12,66,78
82,2,0,3,1,0.234261,203,1918,2121,1,0,13,2,1,0.194,18,79,97
83,2,0,4,1,0.243787,166,1699,1865,1,0,14,2,1,0.2239,9,54,63
84,2,0,5,1,0.230725,300,1910,2210,1,0,15,2,1,0.2537,17,48,65
85,2,0,6,0,0.209571,981,1515,2496,1,0,16,2,1,0.2537,15,68,83
86,2,0,0,0,0.1843,472,1221,1693,1,0,17,2,1,0.2239,10,202,212
87,2,0,1,1,0.212204,222,1806,2028,1,0,18,2,1,0.194,3,179,182
88,2,0,2,1,0.226996,317,2108,2425,1,0,19,2,1,0.1045,2,110,112
89,2,0,3,1,0.172888,168,1368,1536,1,0,20,2,1,0.1045,1,53,54
90,2,0,4,1,0.217646,179,1506,1685,1,0,21,2,1,0.0,0,48,48
91,2,0,5,1,0.258708,307,1920,2227,1,0,22,2,1,0.0896,1,34,35
92,2,0,6,0,0.197146,898,1354,2252,1,0,23,2,1,0.0896,2,9,11
93,2,0,0,0,0.182213,1651,1598,3249,1,0,0,3,1,0.0,0,6,6
94,2,0,1,1,0.385571,734,2381,3115,1,0,1,3,1,0.0896,0,6,6
95,2,0,2,1,0.388067,167,1628,1795,1,0,2,3,1,0.0896,0,2,2
96,2,0,3,1,0.263063,413,2395,2808,1,0,4,3,1,0.2239,0,2,2
97,2,0,4,1,0.162312,571,2570,3141,1,0,5,3,1,0.1642,0,3,3
98,2,0,5,1,0.226992,172,1299,1471,1,0,6,3,1,0.2239,0,33,33
99,2,0,6,0,0.133083,879,1576,2455,1,0,7,3,1,0.194,1,87,88
100,2,0,0,0,0.146767,1188,1707,2895,1,0,8,3,1,0.2985,3,192,195
101,2,0,1,1,0.324474,855,2493,3348,1,0,9,3,1,0.3284,6,109,115
102,2,0,2,1,0.274879,257,1777,2034,1,0,10,3,1,0.3284,4,53,57
103,2,0,3,1,0.250617,209,1953,2162,1,0,11,3,1,0.3284,12,34,46
104,2,0,4,1,0.1107,529,2738,3267,1,0,12,3,1,0.3284,5,74,79
105,2,0,5,0,0.226375,642,2484,3126,1,0,13,3,1,0.2985,6,65,71
106,2,0,6,0,0.340808,121,674,795,1,0,14,3,1,0.194,10,52,62
107,2,0,0,0,0.303496,1558,2186,3744,1,0,15,3,1,0.194,7,55,62
108,2,0,1,1,0.163567,669,2760,3429,1,0,16,3,1,0.0896,4,85,89
109,2,0,2,1,0.157971,409,2795,3204,1,0,17,3,1,0.194,4,186,190
110,2,0,3,1,0.241925,613,3331,3944,1,0,18,3,1,0.1343,3,166,169
111,2,0,4,1,0.325258,745,3444,4189,1,0,19,3,1,0.1045,5,127,132
112,2,0,5,1,0.219521,177,1506,1683,1,0,20,3,1,0.1642,7,82,89
113,2,0,6,0,0.230725,1462,2574,4036,1,0,21,3,1,0.194,3,40,43
114,2,0,0,0,0.192175,1710,2481,4191,1,0,22,3,1,0.1343,1,41,42
115,2,0,1,1,0.185333,773,3300,4073,1,0,23,3,1,0.0,1,18,19
116,2,0,2,1,0.3265,678,3722,4400,1,0,0,4,1,0.0,0,11,11
117,2,0,3,1,0.3122,547,3325,3872,1,0,1,4,1,0.0,0,4,4
118,2,0,4,1,0.320908,569,3489,4058,1,0,2,4,1,0.0,0,2,2
119,2,0,5,1,0.240063,878,3717,4595,1,0,4,4,1,0.0896,0,1,1
120,2,0,6,0,0.235075,1965,3347,5312,1,0,5,4,1,0.0896,0,4,4
121,2,0,0,0,0.106354,1138,2213,3351,1,0,6,4,1,0.1045,0,36,36
122,2,0,1,1,0.183454,847,3554,4401,1,0,7,4,1,0.0,0,95,95
123,2,0,2,1,0.342667,603,3848,4451,1,0,8,4,1,0.0,3,216,219
124,2,0,3,1,0.328996,255,2378,2633,1,0,9,4,1,0.0,6,116,122
125,2,0,4,1,0.295392,614,3819,4433,1,0,10,4,1,0.0,3,42,45
126,2,0,5,1,0.228246,894,3714,4608,1,0,11,4,1,0.0896,2,57,59
127,2,0,6,0,0.16045,1612,3102,4714,1,0,12,4,1,0.0,6,78,84
128,2,0,0,0,0.0746375,1401,2932,4333,1,0,13,4,1,0.1045,12,55,67
129,2,0,1,1,0.176,664,3698,4362,1,0,14,4,1,0.1642,11,59,70
130,2,0,2,1,0.115671,694,4109,4803,1,0,15,4,1,0.0,8,54,62
131,2,0,3,1,0.120642,550,3632,4182,1,0,16,4,1,0.1642,12,74,86
132,2,0,4,1,0.189667,695,4169,4864,1,0,17,4,1,0.1642,9,163,172
133,2,0,5,1,0.179725,692,3413,4105,1,0,18,4,1,0.1343,5,158,163
134,2,0,6,0,0.13495,902,2507,3409,1,0,19,4,1,0.0896,3,109,112
135,2,0,0,0,0.152979,1582,2971,4553,1,0,20,4,1,0.1642,3,66,69
136,2,0,1,1,0.126871,773,3185,3958,1,0,21,4,1,0.2239,0,48,48
137,2,0,2,1,0.277354,678,3445,4123,1,0,22,4,1,0.2836,1,51,52
138,2,0,3,1,0.201492,536,3319,3855,1,0,23,4,1,0.194,4,19,23
139,2,0,4,1,0.108213,735,3840,4575,1,0,0,5,1,0.194,4,13,17
140,2,0,5,1,0.125013,909,4008,4917,1,0,1,5,1,0.2239,2,5,7
141,2,0,6,0,0.12065,2258,3547,5805,1,0,2,5,1,0.2239,0,1,1
142,2,0,0,0,0.148008,1576,3084,4660,1,0,4,5,1,0.1343,0,1,1
143,2,0,1,1,0.233842,836,3438,4274,1,0,5,5,1,0.0,0,5,5
144,2,0,2,1,0.207092,659,3833,4492,1,0,6,5,1,0.0,8,26,34
145,2,0,3,1,0.154233,740,4238,4978,1,0,7,5,1,0.1343,8,76,84
146,2,0,4,1,0.199642,758,3919,4677,1,0,8,5,1,0.2537,20,190,210
147,2,0,5,1,0.240679,871,3808,4679,1,0,9,5,1,0.2985,9,125,134
148,2,0,6,0,0.230092,2001,2757,4758,1,0,10,5,1,0.3284,16,47,63
149,2,0,0,0,0.213938,2355,2433,4788,1,0,11,5,1,0.2239,19,48,67
150,2,0,1,0,0.131225,1549,2549,4098,1,0,12,5,1,0.2537,9,50,59
151,2,0,2,1,0.111329,673,3309,3982,1,0,13,5,1,0.2836,9,64,73
152,2,0,3,1,0.207092,513,3461,3974,1,0,14,5,1,0.2537,7,43,50
153,2,0,4,1,0.292287,736,4232,4968,1,0,15,5,1,0.1642,9,63,72
154,2,0,5,1,0.253121,898,4414,5312,1,0,16,5,1,0.1642,5,82,87
155,2,0,6,0,0.123142,1869,3473,5342,1,0,17,5,1,0.0,9,178,187
156,2,0,0,0,0.138692,1685,3221,4906,1,0,18,5,1,0.0896,7,116,123
157,2,0,1,1,0.121896,673,3875,4548,1,0,19,5,1,0.0896,3,92,95
158,2,0,2,1,0.187808,763,4070,4833,1,0,20,5,1,0.1045,1,50,51
159,2,0,3,1,0.136817,676,3725,4401,1,0,21,5,1,0.1343,0,39,39
160,2,0,4,1,0.149883,563,3352,3915,1,0,22,5,1,0.1642,2,34,36
161,2,0,5,1,0.140554,815,3771,4586,1,0,23,5,1,0.1642,1,14,15
162,2,0,6,0,0.15485,1729,3237,4966,1,0,0,6,0,0.1642,1,24,25
163,2,0,0,0,0.163567,1467,2993,4460,1,0,1,6,0,0.0896,1,15,16
164,2,0,1,1,0.30535,863,4157,5020,1,0,2,6,0,0.0,3,13,16
165,2,0,2,1,0.269283,727,4164,4891,1,0,3,6,0,0.1642,0,7,7
166,2,0,3,1,0.167912,769,4411,5180,1,0,4,6,0,0.1642,0,1,1
167,2,0,4,1,0.206471,545,3222,3767,1,0,5,6,0,0.1642,0,5,5
168,2,0,5,1,0.143029,863,3981,4844,1,0,6,6,0,0.1642,0,2,2
169,2,0,6,0,0.119408,1807,3312,5119,1,0,7,6,0,0.1045,1,8,9
170,2,0,0,0,0.102,1639,3105,4744,1,0,8,6,0,0.1045,0,15,15
171,2,0,1,1,0.155475,699,3311,4010,1,0,9,6,0,0.1045,0,20,20
172,3,0,2,1,0.171025,774,4061,4835,1,0,10,6,0,0.1642,5,56,61
173,3,0,3,1,0.172262,661,3846,4507,1,0,11,6,0,0.3881,2,60,62
174,3,0,4,1,0.238804,746,4044,4790,1,0,12,6,0,0.3582,8,90,98
175,3,0,5,1,0.222025,969,4022,4991,1,0,13,6,0,0.3284,7,95,102
176,3,0,6,0,0.209571,1782,3420,5202,1,0,14,6,0,0.4925,12,83,95
177,3,0,0,0,0.0945333,1920,3385,5305,1,0,15,6,0,0.4478,5,69,74
178,3,0,1,1,0.107588,854,3854,4708,1,0,16,6,0,0.4478,8,68,76
179,3,0,2,1,0.144283,732,3916,4648,1,0,17,6,0,0.5522,5,64,69
180,3,0,3,1,0.261821,848,4377,5225,1,0,18,6,0,0.2985,3,52,55
181,3,0,4,1,0.185312,1027,4488,5515,1,0,19,6,0,0.2537,4,26,30
182,3,0,5,1,0.102608,1246,4116,5362,1,0,20,6,0,0.2537,0,28,28
183,3,0,6,0,0.115062,2204,2915,5119,1,0,21,6,0,0.3582,2,35,37
184,3,0,0,0,0.228858,2282,2367,4649,1,0,22,6,0,0.3881,1,33,34
185,3,0,1,0,0.0814792,3065,2978,6043,1,0,23,6,0,0.4478,0,22,22
186,3,0,2,1,0.126258,1031,3634,4665,1,0,0,0,0,0.3881,1,24,25
187,3,0,3,1,0.149883,784,3845,4629,1,0,1,0,0,0.4627,0,12,12
188,3,0,4,1,0.1592,754,3838,4592,1,0,2,0,0,0.4627,0,11,11
189,3,0,5,1,0.225129,692,3348,4040,1,0,3,0,0,0.4179,0,4,4
190,3,0,6,0,0.167912,1988,3348,5336,1,0,4,0,0,0.194,0,1,1
191,3,0,0,0,0.183471,1743,3138,4881,1,0,5,0,0,0.194,0,1,1
192,3,0,1,1,0.282337,723,3363,4086,1,0,6,0,0,0.2836,0,1,1
193,3,0,2,1,0.200254,662,3596,4258,1,0,7,0,0,0.194,1,5,6
194,3,0,3,1,0.146133,748,3594,4342,1,0,8,0,0,0.2836,0,10,10
195,3,0,4,1,0.240667,888,4196,5084,1,0,9,0,0,0.5224,0,19,19
196,3,0,5,1,0.182833,1318,4220,5538,1,0,10,0,0,0.3881,0,49,49
197,3,0,6,0,0.208342,2418,3505,5923,1,0,11,0,0,0.5224,2,47,49
198,3,0,0,0,0.245033,2006,3296,5302,1,0,12,0,0,0.4478,4,79,83
199,3,0,1,1,0.215804,841,3617,4458,1,0,13,0,0,0.4478,6,69,75
200,3,0,2,1,0.1306,752,3789,4541,1,0,14,0,0,0.4627,8,64,72
201,3,0,3,1,0.113817,644,3688,4332,1,0,15,0,0,0.3582,5,77,82
202,3,0,4,1,0.222021,632,3152,3784,1,0,16,0,0,0.4478,13,79,92
203,3,0,5,1,0.1331,562,2825,3387,1,0,17,0,0,0.3881,3,59,62
204,3,0,6,0,0.131221,987,2298,3285,1,0,18,0,0,0.3284,4,44,48
205,3,0,0,0,0.169171,1050,2556,3606,1,0,19,0,0,0.3284,1,40,41
206,3,0,1,1,0.0908083,568,3272,3840,1,0,20,0,0,0.2537,0,38,38
207,3,0,2,1,0.200258,750,3840,4590,1,0,21,0,0,0.4179,1,19,20
208,3,0,3,1,0.183463,755,3901,4656,1,0,22,0,0,0.2985,5,10,15
209,3,0,4,1,0.178479,606,3784,4390,1,0,23,0,0,0.194,0,6,6
210,3,0,5,1,0.174138,670,3176,3846,1,0,0,1,1,0.2836,2,3,5
211,3,0,6,0,0.168537,1559,2916,4475,1,0,1,1,1,0.2836,1,0,1
212,3,0,0,0,0.164813,1524,2778,4302,1,0,2,1,1,0.2239,0,3,3
213,3,0,1,1,0.156717,729,3537,4266,1,0,3,1,1,0.2239,0,1,1
214,3,0,2,1,0.20585,801,4044,4845,1,0,4,1,1,0.1343,1,2,3
215,3,0,3,1,0.135583,467,3107,3574,1,0,5,1,1,0.2537,0,3,3
216,3,0,4,1,0.19715,799,3777,4576,1,0,6,1,1,0.2836,0,31,31
217,3,0,5,1,0.184696,1023,3843,4866,1,0,7,1,1,0.2239,2,75,77
218,3,0,6,0,0.22825,1521,2773,4294,1,0,8,1,1,0.2836,4,184,188
219,3,0,0,0,0.201487,1298,2487,3785,1,0,9,1,1,0.2537,2,92,94
220,3,0,1,1,0.192175,846,3480,4326,1,0,10,1,1,0.2985,0,31,31
221,3,0,2,1,0.151121,907,3695,4602,1,0,11,1,1,0.2836,2,28,30
222,3,0,3,1,0.200258,884,3896,4780,1,0,12,1,1,0.2836,5,47,52
223,3,0,4,1,0.164796,812,3980,4792,1,0,13,1,1,0.2836,4,50,54
224,3,0,5,1,0.125621,1051,3854,4905,1,0,14,1,1,0.2239,0,47,47
225,3,0,6,0,0.211454,1504,2646,4150,1,0,15,1,1,0.2239,2,43,45
226,3,0,0,0,0.222633,1338,2482,3820,1,0,16,1,1,0.1343,4,70,74
227,3,0,1,1,0.208954,775,3563,4338,1,0,17,1,1,0.1045,4,174,178
228,3,0,2,1,0.236329,721,4004,4725,1,0,18,1,1,0.2239,1,154,155
229,3,0,3,1,0.143667,668,4026,4694,1,0,19,1,1,0.1642,3,92,95
230,3,0,4,1,0.233208,639,3166,3805,1,0,20,1,1,0.1642,1,73,74
231,3,0,5,1,0.139308,797,3356,4153,1,0,21,1,1,0.194,1,37,38
232,3,0,6,0,0.104467,1914,3277,5191,1,0,22,1,1,0.1642,2,22,24
233,3,0,0,0,0.248754,1249,2624,3873,1,0,23,1,1,0.1642,0,18,18
234,3,0,1,1,0.27675,833,3925,4758,1,0,0,2,1,0.1045,2,10,12
235,3,0,2,1,0.146763,1281,4614,5895,1,0,1,2,1,0.1642,0,3,3
236,3,0,3,1,0.253108,949,4181,5130,1,0,2,2,1,0.194,0,3,3
237,3,0,4,1,0.210833,435,3107,3542,1,0,5,2,1,0.1343,0,6,6
238,3,0,5,1,0.0839625,768,3893,4661,1,0,6,2,1,0.1343,0,27,27
239,3,0,6,0,0.375617,226,889,1115,1,0,7,2,1,0.0,2,97,99
240,3,0,0,0,0.304659,1415,2919,4334,1,0,8,2,1,0.0896,3,214,217
241,3,0,1,1,0.159825,729,3905,4634,1,0,9,2,1,0.1642,3,127,130
242,3,0,2,1,0.125008,775,4429,5204,1,0,10,2,1,0.1642,3,51,54
243,3,0,3,1,0.0833333,688,4370,5058,1,0,11,2,1,0.1343,4,31,35
244,3,0,4,1,0.141796,783,4332,5115,1,0,12,2,1,0.1045,2,55,57
245,3,0,5,1,0.139929,875,3852,4727,1,0,13,2,1,0.0896,6,46,52
246,3,0,6,0,0.185325,1935,2549,4484,1,0,14,2,1,0.0896,3,60,63
247,3,0,0,0,0.206467,2521,2419,4940,1,0,15,2,1,0.0896,2,45,47
248,3,0,1,0,0.212696,1236,2115,3351,1,0,16,2,1,0.2239,4,72,76
249,3,0,2,1,0.343943,204,2506,2710,1,0,17,2,1,0.2239,6,130,136
250,3,0,3,1,0.0970208,118,1878,1996,1,0,18,2,1,0.1045,1,94,95
251,3,0,4,1,0.192748,153,1689,1842,1,0,19,2,1,0.0,0,51,51
252,3,0,5,1,0.124379,417,3127,3544,1,0,20,2,1,0.194,0,32,32
253,3,0,6,0,0.153608,1750,3595,5345,1,0,21,2,1,0.0896,0,20,20
254,3,0,0,0,0.115054,1633,3413,5046,1,0,22,2,1,0.1045,1,28,29
255,3,0,1,1,0.088913,690,4023,4713,1,0,23,2,1,0.0896,1,18,19
256,3,0,2,1,0.141804,701,4062,4763,1,0,0,3,1,0.0896,0,7,7
257,3,0,3,1,0.1673,647,4138,4785,1,0,1,3,1,0.1045,0,6,6
258,3,0,4,1,0.271146,428,3231,3659,1,0,2,3,1,0.1343,0,1,1
259,3,0,5,1,0.164183,742,4018,4760,1,0,5,3,1,0.1642,0,5,5
260,3,0,6,0,0.189675,1434,3077,4511,1,0,6,3,1,0.1343,0,16,16
261,3,0,0,0,0.178483,1353,2921,4274,1,0,7,3,1,0.1343,0,54,54
262,3,0,1,1,0.151742,691,3848,4539,1,0,8,3,1,0.1642,3,125,128
263,3,0,2,1,0.134954,438,3203,3641,1,0,9,3,1,0.3284,3,78,81
264,3,0,3,1,0.0964042,539,3813,4352,1,0,10,3,1,0.2239,0,39,39
265,3,0,4,1,0.128125,555,4240,4795,1,0,11,3,1,0.3881,3,32,35
266,4,0,5,1,0.0783667,258,2137,2395,1,0,12,3,1,0.5821,3,52,55
267,4,0,6,0,0.0783833,1776,3647,5423,1,0,13,3,1,0.3582,0,49,49
268,4,0,0,0,0.0503792,1544,3466,5010,1,0,14,3,1,0.3284,0,44,44
269,4,0,1,1,0.1107,684,3946,4630,1,0,15,3,1,0.4179,1,48,49
270,4,0,2,1,0.118171,477,3643,4120,1,0,16,3,1,0.3284,5,63,68
271,4,0,3,1,0.148629,480,3427,3907,1,0,17,3,1,0.3582,0,139,139
272,4,0,4,1,0.172883,653,4186,4839,1,0,18,3,1,0.5224,2,135,137
273,4,0,5,1,0.206475,830,4372,5202,1,0,19,3,1,0.4179,1,82,83
274,4,0,6,0,0.292296,480,1949,2429,1,0,20,3,1,0.3284,2,54,56
275,4,0,0,0,0.222013,616,2302,2918,1,0,21,3,1,0.3284,0,57,57
276,4,0,1,1,0.0833458,330,3240,3570,1,0,22,3,1,0.4478,1,32,33
277,4,0,2,1,0.205854,486,3970,4456,1,0,23,3,1,0.4179,1,19,20
278,4,0,3,1,0.17725,559,4267,4826,1,0,0,4,1,0.2836,1,6,7
279,4,0,4,1,0.134954,639,4126,4765,1,0,1,4,1,0.2836,0,2,2
280,4,0,5,1,0.0223917,949,4036,4985,1,0,2,4,1,0.3582,0,2,2
281,4,0,6,0,0.0454042,2235,3174,5409,1,0,3,4,1,0.3284,0,3,3
282,4,0,0,0,0.06345,2397,3114,5511,1,0,4,4,1,0.2537,0,4,4
283,4,0,1,0,0.0423042,1514,3603,5117,1,0,5,4,1,0.2985,0,3,3
284,4,0,2,1,0.143042,667,3896,4563,1,0,6,4,1,0.1343,0,28,28
285,4,0,3,1,0.24815,217,2199,2416,1,0,7,4,1,0.1343,0,72,72
286,4,0,4,1,0.141787,290,2623,2913,1,0,8,4,1,0.194,5,197,202
287,4,0,5,1,0.223883,529,3115,3644,1,0,9,4,1,0.3284,2,137,139
288,4,0,6,0,0.258083,1899,3318,5217,1,0,10,4,1,0.3582,2,36,38
289,4,0,0,0,0.281717,1748,3293,5041,1,0,11,4,1,0.4478,4,33,37
290,4,0,1,1,0.175379,713,3857,4570,1,0,12,4,1,0.4179,3,49,52
291,4,0,2,1,0.110087,637,4111,4748,1,0,13,4,1,0.4478,2,81,83
292,4,0,3,1,0.243339,254,2170,2424,1,0,14,4,1,0.3881,3,39,42
293,4,0,4,1,0.422275,471,3724,4195,1,0,15,4,1,0.2985,5,55,60
294,4,0,5,1,0.221396,676,3628,4304,1,0,16,4,1,0.3582,2,76,78
295,4,0,6,0,0.0926667,1499,2809,4308,1,0,17,4,1,0.2836,4,158,162
296,4,0,0,0,0.0995125,1619,2762,4381,1,0,18,4,1,0.3284,3,141,144
297,4,0,1,1,0.118792,699,3488,4187,1,0,19,4,1,0.2537,1,98,99
298,4,0,2,1,0.166658,695,3992,4687,1,0,20,4,1,0.2239,0,64,64
299,4,0,3,1,0.148642,404,3490,3894,1,0,21,4,1,0.2985,0,40,40
300,4,0,4,1,0.197763,240,2419,2659,1,0,22,4,1,0.3284,0,30,30
301,4,0,5,1,0.229479,456,3291,3747,1,0,23,4,1,0.194,1,14,15
302,4,0,6,0,0.351371,57,570,627,1,0,0,5,1,0.194,0,14,14
303,4,0,0,0,0.176617,885,2446,3331,1,0,1,5,1,0.1642,0,5,5
304,4,0,1,1,0.10635,362,3307,3669,1,0,2,5,1,0.1343,0,1,1
305,4,0,2,1,0.135571,410,3658,4068,1,0,3,5,1,0.1045,0,1,1
306,4,0,3,1,0.0820917,370,3816,4186,1,0,5,5,1,0.0896,0,8,8
307,4,0,4,1,0.136817,318,3656,3974,1,0,6,5,1,0.0,0,17,17
308,4,0,5,1,0.271779,470,3576,4046,1,0,7,5,1,0.1642,0,70,70
309,4,0,6,0,0.189062,1156,2770,3926,1,0,8,5,1,0.0,2,156,158
310,4,0,0,0,0.0920542,952,2697,3649,1,0,9,5,1,0.1343,0,117,117
311,4,0,1,1,0.057225,373,3662,4035,1,0,10,5,1,0.194,4,40,44
312,4,0,2,1,0.0690375,376,3829,4205,1,0,11,5,1,0.2836,6,47,53
313,4,0,3,1,0.0621958,305,3804,4109,1,0,12,5,1,0.2537,2,59,61
314,4,0,4,1,0.189067,190,2743,2933,1,0,13,5,1,0.3881,4,73,77
315,4,0,5,0,0.314675,440,2928,3368,1,0,14,5,1,0.2836,5,59,64
316,4,0,6,0,0.212062,1275,2792,4067,1,0,15,5,1,0.1642,9,59,68
317,4,0,0,0,0.281721,1004,2713,3717,1,0,16,5,1,0.1045,3,87,90
318,4,0,1,1,0.306596,595,3891,4486,1,0,17,5,1,0.1642,4,155,159
319,4,0,2,1,0.199633,449,3746,4195,1,0,18,5,1,0.0,5,134,139
320,4,0,3,1,0.136829,145,1672,1817,1,0,19,5,1,0.0896,3,89,92
321,4,0,4,1,0.305362,139,2914,3053,1,0,20,5,1,0.0,0,68,68
322,4,0,5,1,0.168533,245,3147,3392,1,0,21,5,1,0.0,4,48,52
323,4,0,6,0,0.224496,943,2720,3663,1,0,22,5,1,0.0,2,34,36
324,4,0,0,0,0.18595,787,2733,3520,1,0,23,5,1,0.0,1,26,27
325,4,0,1,1,0.138054,220,2545,2765,1,0,0,6,0,0.0,3,25,28
326,4,0,2,1,0.118792,69,1538,1607,1,0,1,6,0,0.0896,2,18,20
327,4,0,3,1,0.335825,112,2454,2566,1,0,2,6,0,0.0896,0,12,12
328,4,0,4,0,0.167304,560,935,1495,1,0,3,6,0,0.0,1,7,8
329,4,0,5,1,0.0988958,1095,1697,2792,1,0,4,6,0,0.0,0,5,5
330,4,0,6,0,0.0684208,1249,1819,3068,1,0,5,6,0,0.0,0,1,1
331,4,0,0,0,0.208954,810,2261,3071,1,0,6,6,0,0.1045,1,2,3
332,4,0,1,1,0.142122,253,3614,3867,1,0,7,6,0,0.0,1,9,10
333,4,0,2,1,0.258092,96,2818,2914,1,0,8,6,0,0.1343,1,22,23
334,4,0,3,1,0.271158,188,3425,3613,1,0,9,6,0,0.1343,2,31,33
335,4,0,4,1,0.220158,182,3545,3727,1,0,10,6,0,0.1642,2,57,59
336,4,0,5,1,0.100754,268,3672,3940,1,0,11,6,0,0.2239,18,54,72
337,4,0,6,0,0.0957833,706,2908,3614,1,0,12,6,0,0.2239,15,74,89
338,4,0,0,0,0.0839583,634,2851,3485,1,0,13,6,0,0.2985,21,80,101
339,4,0,1,1,0.0622083,233,3578,3811,1,0,14,6,0,0.2836,26,92,118
340,4,0,2,1,0.232583,126,2468,2594,1,0,15,6,0,0.194,21,108,129
341,4,0,3,1,0.266175,50,655,705,1,0,16,6,0,0.194,33,95,128
342,4,0,4,1,0.240058,150,3172,3322,1,0,17,6,0,0.2836,29,54,83
343,4,0,5,1,0.0827167,261,3359,3620,1,0,18,6,0,0.2537,15,69,84
344,4,0,6,0,0.233221,502,2688,3190,1,0,19,6,0,0.2537,14,60,74
345,4,0,0,0,0.0665417,377,2366,2743,1,0,20,6,0,0.2537,6,35,41
346,4,0,1,1,0.06345,143,3167,3310,1,0,21,6,0,0.2239,6,51,57
347,4,0,2,1,0.14055,155,3368,3523,1,0,22,6,0,0.1045,0,26,26
348,4,0,3,1,0.0609583,178,3562,3740,1,0,23,6,0,0.2836,5,39,44
349,4,0,4,1,0.268042,181,3528,3709,1,0,0,0,0,0.0,6,33,39
350,4,0,5,1,0.260575,178,3399,3577,1,0,1,0,0,0.1343,4,19,23
351,4,0,6,0,0.243167,275,2464,2739,1,0,2,0,0,0.0896,3,13,16
352,4,0,0,0,0.169779,220,2211,2431,1,0,3,0,0,0.0,9,6,15
353,4,0,1,1,0.172896,260,3143,3403,1,0,4,0,0,0.1642,0,1,1
354,4,0,2,1,0.0615708,216,3534,3750,1,0,5,0,0,0.1642,1,1,2
355,1,0,3,1,0.2214,107,2553,2660,1,0,6,0,0,0.1642,0,1,1
356,1,0,4,1,0.047275,227,2841,3068,1,0,7,0,0,0.2985,0,3,3
357,1,0,5,1,0.274246,163,2046,2209,1,0,8,0,0,0.2836,0,18,18
358,1,0,6,0,0.190304,155,856,1011,1,0,9,0,0,0.2537,3,29,32
359,1,0,0,0,0.155091,303,451,754,1,0,10,0,0,0.2836,8,71,79
360,1,0,1,0,0.239465,430,887,1317,1,0,11,0,0,0.2537,23,70,93
361,1,0,2,1,0.18845,103,1059,1162,1,0,12,0,0,0.2836,29,75,104
362,1,0,3,1,0.293961,255,2047,2302,1,0,13,0,0,0.2985,23,95,118
363,1,0,4,1,0.119412,254,2169,2423,1,0,14,0,0,0.2537,22,69,91
364,1,0,5,1,0.134337,491,2508,2999,1,0,15,0,0,0.2537,35,78,113
365,1,0,6,0,0.220154,665,1820,2485,1,0,16,0,0,0.2239,22,77,99
366,1,1,0,0,0.192167,686,1608,2294,1,0,17,0,0,0.2537,23,82,105
367,1,1,1,0,0.329665,244,1707,1951,1,0,18,0,0,0.1642,11,56,67
368,1,1,2,1,0.365671,89,2147,2236,1,0,19,0,0,0.1343,14,47,61
369,1,1,3,1,0.1847,95,2273,2368,1,0,20,0,0,0.1642,7,50,57
370,1,1,4,1,0.129987,140,3132,3272,1,0,21,0,0,0.1642,6,22,28
371,1,1,5,1,0.167908,307,3791,4098,1,0,22,0,0,0.1343,2,19,21
372,1,1,6,0,0.174758,1070,3451,4521,1,0,23,0,0,0.1045,0,18,18
373,1,1,0,0,0.191542,599,2826,3425,1,0,0,1,0,0.2239,1,16,17
374,1,1,1,1,0.0989,106,2270,2376,1,0,1,1,0,0.194,1,15,16
375,1,1,2,1,0.187552,173,3425,3598,1,0,2,1,0,0.2537,0,8,8
376,1,1,3,1,0.131221,92,2085,2177,1,0,3,1,0,0.194,0,2,2
377,1,1,4,1,0.180967,269,3828,4097,1,0,4,1,0,0.1343,1,2,3
378,1,1,5,1,0.378108,174,3040,3214,1,0,5,1,0,0.1642,0,1,1
379,1,1,6,0,0.187183,333,2160,2493,1,0,6,1,0,0.194,0,5,5
380,1,1,0,0,0.251258,284,2027,2311,1,0,7,1,0,0.1343,4,9,13
381,1,1,1,0,0.231358,217,2081,2298,1,0,8,1,0,0.2239,3,30,33
382,1,1,2,1,0.34913,127,2808,2935,1,0,9,1,0,0.2239,8,39,47
383,1,1,3,1,0.415429,109,3267,3376,1,0,10,1,0,0.2537,7,50,57
384,1,1,4,1,0.220158,130,3162,3292,1,0,11,1,0,0.194,9,55,64
385,1,1,5,1,0.20275,115,3048,3163,1,0,12,1,0,0.1343,10,70,80
386,1,1,6,0,0.222642,67,1234,1301,1,0,13,1,0,0.1343,13,80,93
387,1,1,0,0,0.199638,196,1781,1977,1,0,14,1,0,0.1045,12,74,86
388,1,1,1,1,0.110708,145,2287,2432,1,0,15,1,0,0.1642,21,72,93
389,1,1,2,1,0.123767,439,3900,4339,1,0,16,1,0,0.1642,6,76,82
390,1,1,3,1,0.161071,467,3803,4270,1,0,17,1,0,0.194,4,67,71
391,1,1,4,1,0.0733958,244,3831,4075,1,0,18,1,0,0.2537,7,85,92
392,1,1,5,1,0.342667,269,3187,3456,1,0,19,1,0,0.194,2,58,60
393,1,1,6,0,0.210829,775,3248,4023,1,0,20,1,0,0.194,4,29,33
394,1,1,0,0,0.24005,558,2685,3243,1,0,21,1,0,0.194,3,24,27
395,1,1,1,1,0.215792,126,3498,3624,1,0,22,1,0,0.2537,0,13,13
396,1,1,2,1,0.261817,324,4185,4509,1,0,23,1,0,0.2836,1,3,4
397,1,1,3,1,0.189067,304,4275,4579,1,0,12,2,1,0.3284,0,3,3
398,1,1,4,1,0.187187,190,3571,3761,1,0,13,2,1,0.2239,0,22,22
399,1,1,5,1,0.178496,310,3841,4151,1,0,14,2,1,0.1642,2,26,28
400,1,1,6,0,0.121896,384,2448,2832,1,0,15,2,1,0.1642,3,32,35
401,1,1,0,0,0.175996,318,2629,2947,1,0,16,2,1,0.194,0,61,61
402,1,1,1,1,0.1538,206,3578,3784,1,0,17,2,1,0.194,1,124,125
403,1,1,2,1,0.147379,199,4176,4375,1,0,18,2,1,0.1642,1,132,133
404,1,1,3,1,0.133721,109,2693,2802,1,0,19,2,1,0.1343,1,98,99
405,1,1,4,1,0.194037,163,3667,3830,1,0,20,2,1,0.0,0,83,83
406,1,1,5,1,0.116929,227,3604,3831,1,0,21,2,1,0.1045,0,41,41
407,1,1,6,0,0.289796,192,1977,2169,1,0,22,2,1,0.0896,0,33,33
408,1,1,0,0,0.409212,73,1456,1529,1,0,23,2,1,0.0,1,19,20
409,1,1,1,1,0.167283,94,3328,3422,1,0,0,3,1,0.0,0,3,3
410,1,1,2,1,0.141179,135,3787,3922,1,0,1,3,1,0.1343,1,6,7
411,1,1,3,1,0.1816,141,4028,4169,1,0,2,3,1,0.1343,0,3,3
412,1,1,4,1,0.091425,74,2931,3005,1,0,4,3,1,0.1343,1,1,2
413,1,1,5,1,0.205846,349,3805,4154,1,0,5,3,1,0.0896,0,7,7
414,1,1,6,0,0.190929,1435,2883,4318,1,0,6,3,1,0.0896,0,32,32
415,1,1,0,0,0.253112,618,2071,2689,1,0,7,3,1,0.1045,1,89,90
416,1,1,1,0,0.229083,502,2627,3129,1,0,8,3,1,0.1045,1,196,197
417,1,1,2,1,0.205717,163,3614,3777,1,0,9,3,1,0.1045,2,107,109
418,1,1,3,1,0.234471,394,4379,4773,1,0,10,3,1,0.1343,1,46,47
419,1,1,4,1,0.190913,516,4546,5062,1,0,11,3,1,0.0896,5,47,52
420,1,1,5,1,0.237567,246,3241,3487,1,0,12,3,1,0.0896,5,65,70
421,1,1,6,0,0.421642,317,2415,2732,1,0,13,3,1,0.2836,11,67,78
422,1,1,0,0,0.205229,515,2874,3389,1,0,14,3,1,0.2537,7,68,75
423,1,1,1,1,0.268033,253,4069,4322,1,0,15,3,1,0.2836,4,78,82
424,1,1,2,1,0.193417,229,4134,4363,1,0,16,3,1,0.3881,10,94,104
425,1,1,3,1,0.179117,65,1769,1834,1,0,17,3,1,0.3284,7,190,197
426,1,1,4,1,0.226987,325,4665,4990,1,0,18,3,1,0.2836,5,156,161
427,1,1,5,1,0.144904,246,2948,3194,1,0,19,3,1,0.4179,4,108,112
428,1,1,6,0,0.161079,956,3110,4066,1,0,20,3,1,0.2985,2,74,76
429,1,1,0,0,0.334571,710,2713,3423,1,0,21,3,1,0.4179,4,55,59
430,1,1,1,1,0.228858,203,3130,3333,1,0,22,3,1,0.1642,6,53,59
431,1,1,2,1,0.200875,221,3735,3956,1,0,23,3,1,0.4627,1,27,28
432,1,1,3,1,0.345779,432,4484,4916,1,0,0,4,1,0.3881,5,8,13
433,1,1,4,1,0.441563,486,4896,5382,1,0,1,4,1,0.0,2,3,5
434,1,1,5,1,0.4148,447,4122,4569,1,0,2,4,1,0.0,0,2,2
435,1,1,6,0,0.22575,968,3150,4118,1,0,3,4,1,0.1642,0,1,1
436,1,1,0,0,0.222587,1658,3253,4911,1,0,4,4,1,0.1642,0,1,1
437,1,1,1,1,0.207713,838,4460,5298,1,0,5,4,1,0.2239,0,6,6
438,1,1,2,1,0.23695,762,5085,5847,1,0,6,4,1,0.2239,0,35,35
439,1,1,3,1,0.115062,997,5315,6312,1,0,7,4,1,0.2239,1,100,101
440,1,1,4,1,0.149883,1005,5187,6192,1,0,8,4,1,0.2836,2,247,249
441,1,1,5,1,0.113192,548,3830,4378,1,0,9,4,1,0.2239,3,140,143
442,1,1,6,0,0.110704,3155,4681,7836,1,0,10,4,1,0.2985,1,56,57
443,1,1,0,0,0.126883,2207,3685,5892,1,0,11,4,1,0.1642,5,63,68
444,1,1,1,1,0.162317,982,5171,6153,1,0,12,4,1,0.0,7,77,84
445,1,1,2,1,0.121271,1051,5042,6093,1,0,13,4,1,0.1045,12,86,98
446,2,1,3,1,0.0895583,1122,5108,6230,1,0,14,4,1,0.1343,6,75,81
447,2,1,4,1,0.117562,1334,5537,6871,1,0,15,4,1,0.194,8,62,70
448,2,1,5,1,0.1163,2469,5893,8362,1,0,16,4,1,0.1343,8,83,91
449,2,1,6,0,0.192783,1033,2339,3372,1,0,17,4,1,0.1045,8,207,215
450,2,1,0,0,0.220775,1532,3464,4996,1,0,18,4,1,0.194,1,184,185
451,2,1,1,1,0.386821,795,4763,5558,1,0,19,4,1,0.3284,6,146,152
452,2,1,2,1,0.187192,531,4571,5102,1,0,20,4,1,0.2836,2,124,126
453,2,1,3,1,0.291671,674,5024,5698,1,0,21,4,1,0.2537,3,54,57
454,2,1,4,1,0.31965,834,5299,6133,1,0,22,4,1,0.2836,0,56,56
455,2,1,5,1,0.138067,796,4663,5459,1,0,23,4,1,0.3284,3,28,31
456,2,1,6,0,0.250617,2301,3934,6235,1,0,0,5,1,0.2537,1,20,21
457,2,1,0,0,0.172267,2347,3694,6041,1,0,1,5,1,0.2537,0,6,6
458,2,1,1,1,0.312139,1208,4728,5936,1,0,2,5,1,0.1642,0,2,2
459,2,1,2,1,0.100133,1348,5424,6772,1,0,3,5,1,0.2985,0,1,1
460,2,1,3,1,0.180975,1058,5378,6436,1,0,4,5,1,0.0896,0,1,1
461,2,1,4,1,0.219529,1192,5265,6457,1,0,5,5,1,0.4179,1,4,5
462,2,1,5,1,0.300388,1807,4653,6460,1,0,6,5,1,0.2537,0,27,27
463,2,1,6,0,0.274871,3252,3605,6857,1,0,7,5,1,0.2836,2,66,68
464,2,1,0,0,0.232596,2230,2939,5169,1,0,8,5,1,0.3284,7,210,217
465,2,1,1,1,0.358196,905,4680,5585,1,0,9,5,1,0.3582,7,159,166
466,2,1,2,1,0.249375,819,5099,5918,1,0,10,5,1,0.4627,6,57,63
467,2,1,3,1,0.295274,482,4380,4862,1,0,11,5,1,0.4627,6,53,59
468,2,1,4,1,0.290429,663,4746,5409,1,0,12,5,1,0.5821,11,67,78
469,2,1,5,1,0.155471,1252,5146,6398,1,0,13,5,1,0.5821,8,65,73
470,2,1,6,0,0.190917,2795,4665,7460,1,0,14,5,1,0.5224,6,56,62
471,2,1,0,0,0.225129,2846,4286,7132,1,0,15,5,1,0.4478,4,61,65
472,2,1,1,0,0.284829,1198,5172,6370,1,0,16,5,1,0.3582,0,97,97
473,2,1,2,1,0.273629,989,5702,6691,1,0,17,5,1,0.3582,10,151,161
474,2,1,3,1,0.167912,347,4020,4367,1,0,18,5,1,0.2537,1,119,120
475,2,1,4,1,0.0659292,846,5719,6565,1,0,19,5,1,0.3284,3,93,96
476,2,1,5,1,0.149871,1340,5950,7290,1,0,20,5,1,0.4179,1,52,53
477,2,1,6,0,0.283587,2541,4083,6624,1,0,21,5,1,0.2836,0,41,41
478,2,1,0,0,0.344546,120,907,1027,1,0,22,5,1,0.3881,1,33,34
479,2,1,1,1,0.303496,195,3019,3214,1,0,23,5,1,0.3284,0,27,27
480,2,1,2,1,0.249383,518,5115,5633,1,0,0,6,0,0.2537,0,13,13
481,2,1,3,1,0.118792,655,5541,6196,1,0,1,6,0,0.3881,3,9,12
482,2,1,4,1,0.176625,475,4551,5026,1,0,2,6,0,0.2537,0,11,11
483,2,1,5,1,0.347633,1014,5219,6233,1,0,3,6,0,0.2836,1,6,7
484,2,1,6,0,0.129975,1120,3100,4220,1,0,4,6,0,0.2985,0,3,3
485,2,1,0,0,0.116908,2229,4075,6304,1,0,6,6,0,0.2239,0,2,2
486,2,1,1,1,0.171638,665,4907,5572,1,0,7,6,0,0.2836,0,8,8
487,2,1,2,1,0.156096,653,5087,5740,1,0,8,6,0,0.3284,1,26,27
488,2,1,3,1,0.138058,667,5502,6169,1,0,9,6,0,0.2537,3,37,40
489,2,1,4,1,0.133696,764,5657,6421,1,0,10,6,0,0.1642,3,50,53
490,2,1,5,1,0.162938,1069,5227,6296,1,0,11,6,0,0.1343,4,59,63
491,2,1,6,0,0.152992,2496,4387,6883,1,0,12,6,0,0.1045,10,60,70
492,2,1,0,0,0.149879,2135,4224,6359,1,0,13,6,0,0.0,12,72,84
493,2,1,1,1,0.230721,1008,5265,6273,1,0,14,6,0,0.1045,11,64,75
494,2,1,2,1,0.296029,738,4990,5728,1,0,15,6,0,0.0,10,93,103
495,2,1,3,1,0.216412,620,4097,4717,1,0,16,6,0,0.194,11,72,83
496,2,1,4,1,0.314063,1026,5546,6572,1,0,17,6,0,0.0,8,59,67
497,2,1,5,1,0.236937,1319,5711,7030,1,0,18,6,0,0.194,0,54,54
498,2,1,6,0,0.123133,2622,4807,7429,1,0,19,6,0,0.1343,6,53,59
499,2,1,0,0,0.225117,2172,3946,6118,1,0,20,6,0,0.1642,1,44,45
500,2,1,1,1,0.212692,342,2501,2843,1,0,21,6,0,0.0896,0,39,39
501,2,1,2,1,0.147392,625,4490,5115,1,0,22,6,0,0.0,7,23,30
502,2,1,3,1,0.122512,991,6433,7424,1,0,23,6,0,0.1045,2,31,33
503,2,1,4,1,0.229475,1242,6142,7384,1,0,0,0,0,0.1045,2,20,22
504,2,1,5,1,0.136817,1521,6118,7639,1,0,1,0,0,0.1045,1,12,13
505,2,1,6,0,0.083975,3410,4884,8294,1,0,2,0,0,0.1343,3,15,18
506,2,1,0,0,0.254367,2704,4425,7129,1,0,3,0,0,0.1343,1,4,5
507,2,1,1,1,0.233204,630,3729,4359,1,0,5,0,0,0.1045,0,3,3
508,2,1,2,1,0.118167,819,5254,6073,1,0,6,0,0,0.1045,0,1,1
509,2,1,3,1,0.102,766,4494,5260,1,0,7,0,0,0.1642,1,1,2
510,2,1,4,1,0.172896,1059,5711,6770,1,0,8,0,0,0.1642,2,17,19
511,2,1,5,1,0.14055,1417,5317,6734,1,0,9,0,0,0.3582,3,25,28
512,2,1,6,0,0.198992,2855,3681,6536,1,0,10,0,0,0.3881,7,51,58
513,2,1,0,0,0.215171,3283,3308,6591,1,0,11,0,0,0.2239,22,77,99
514,2,1,1,0,0.196521,2557,3486,6043,1,0,12,0,0,0.4627,24,92,116
515,2,1,2,1,0.2954,880,4863,5743,1,0,13,0,0,0.3881,12,75,87
516,2,1,3,1,0.134329,745,6110,6855,1,0,14,0,0,0.3582,17,93,110
517,2,1,4,1,0.195279,1100,6238,7338,1,0,15,0,0,0.3582,13,64,77
518,2,1,5,1,0.237563,533,3594,4127,1,0,16,0,0,0.3284,9,56,65
519,2,1,6,0,0.186562,2795,5325,8120,1,0,17,0,0,0.3881,5,50,55
520,2,1,0,0,0.184087,2494,5147,7641,1,0,18,0,0,0.2537,5,44,49
521,2,1,1,1,0.284833,1071,5927,6998,1,0,19,0,0,0.2836,5,45,50
522,2,1,2,1,0.209575,968,6033,7001,1,0,20,0,0,0.2537,4,31,35
523,2,1,3,1,0.077125,1027,6028,7055,1,0,21,0,0,0.194,5,20,25
524,2,1,4,1,0.15735,1038,6456,7494,1,0,22,0,0,0.194,5,23,28
525,2,1,5,1,0.175383,1488,6248,7736,1,0,23,0,0,0.2239,4,17,21
526,2,1,6,0,0.144287,2708,4790,7498,1,0,0,1,1,0.194,0,7,7
527,2,1,0,0,0.133721,2224,4374,6598,1,0,1,1,1,0.194,0,1,1
528,2,1,1,1,0.207713,1017,5647,6664,1,0,3,1,1,0.2537,0,1,1
529,2,1,2,1,0.214546,477,4495,4972,1,0,4,1,1,0.1343,0,1,1
530,2,1,3,1,0.343279,1173,6248,7421,1,0,5,1,1,0.1343,0,5,5
531,2,1,4,1,0.253733,1180,6183,7363,1,0,6,1,1,0.0896,0,15,15
532,2,1,5,1,0.176617,1563,6102,7665,1,0,7,1,1,0.0,5,79,84
533,2,1,6,0,0.166667,2963,4739,7702,1,0,8,1,1,0.0,6,171,177
534,2,1,0,0,0.144904,2634,4344,6978,1,0,9,1,1,0.0,4,98,102
535,2,1,1,1,0.174746,653,4446,5099,1,0,10,1,1,0.0,6,34,40
536,2,1,2,1,0.148017,968,5857,6825,1,0,11,1,1,0.1343,3,43,46
537,2,1,3,1,0.113812,872,5339,6211,1,0,12,1,1,0.194,11,52,63
538,3,1,4,1,0.118787,778,5127,5905,1,0,13,1,1,0.2239,6,54,60
539,3,1,5,1,0.182842,964,4859,5823,1,0,14,1,1,0.2239,2,43,45
540,3,1,6,0,0.179721,2657,4801,7458,1,0,15,1,1,0.1642,7,50,57
541,3,1,0,0,0.145525,2551,4340,6891,1,0,16,1,1,0.2537,4,66,70
542,3,1,1,1,0.300383,1139,5640,6779,1,0,17,1,1,0.2537,6,178,184
543,3,1,2,1,0.347642,1077,6365,7442,1,0,18,1,1,0.194,8,145,153
544,3,1,3,1,0.271775,1077,6258,7335,1,0,19,1,1,0.1642,5,101,106
545,3,1,4,1,0.17165,921,5958,6879,1,0,20,1,1,0.194,1,80,81
546,3,1,5,1,0.165417,829,4634,5463,1,0,21,1,1,0.1642,6,53,59
547,3,1,6,0,0.161071,1455,4232,5687,1,0,22,1,1,0.2239,3,32,35
548,3,1,0,0,0.168529,1421,4110,5531,1,0,23,1,1,0.2537,3,21,24
549,3,1,1,1,0.195267,904,5323,6227,1,0,0,2,1,0.2836,3,6,9
550,3,1,2,1,0.126237,1052,5608,6660,1,0,1,2,1,0.1642,0,5,5
551,3,1,3,0,0.13495,2562,4841,7403,1,0,2,2,1,0.2239,0,2,2
552,3,1,4,1,0.194029,1405,4836,6241,1,0,4,2,1,0.1045,0,1,1
553,3,1,5,1,0.146142,1366,4841,6207,1,0,5,2,1,0.2239,0,9,9
554,3,1,6,0,0.163554,1448,3392,4840,1,0,6,2,1,0.1045,1,35,36
555,3,1,0,0,0.125629,1203,3469,4672,1,0,7,2,1,0.2239,5,103,108
556,3,1,1,1,0.180975,998,5571,6569,1,0,8,2,1,0.1343,5,233,238
557,3,1,2,1,0.151737,954,5336,6290,1,0,9,2,1,0.0896,10,134,144
558,3,1,3,1,0.151733,975,6289,7264,1,0,10,2,1,0.1045,6,49,55
559,3,1,4,1,0.146775,1032,6414,7446,1,0,11,2,1,0.1343,6,55,61
560,3,1,5,1,0.08085,1511,5988,7499,1,0,12,2,1,0.0896,21,85,106
561,3,1,6,0,0.143679,2355,4614,6969,1,0,13,2,1,0.1343,21,72,93
562,3,1,0,0,0.166667,1920,4111,6031,1,0,14,2,1,0.0,11,57,68
563,3,1,1,1,0.164187,1088,5742,6830,1,0,15,2,1,0.0,21,63,84
564,3,1,2,1,0.114429,921,5865,6786,1,0,16,2,1,0.0,14,102,116
565,3,1,3,1,0.137442,799,4914,5713,1,0,17,2,1,0.0,14,208,222
566,3,1,4,1,0.165429,888,5703,6591,1,0,18,2,1,0.0896,7,218,225
567,3,1,5,1,0.208967,747,5123,5870,1,0,19,2,1,0.1642,13,133,146
568,3,1,6,0,0.2133,1264,3195,4459,1,0,20,2,1,0.194,16,103,119
569,3,1,0,0,0.0939208,2544,4866,7410,1,0,21,2,1,0.194,5,40,45
570,3,1,1,1,0.138683,1135,5831,6966,1,0,22,2,1,0.1642,4,49,53
571,3,1,2,1,0.211454,1140,6452,7592,1,0,23,2,1,0.1642,3,37,40
572,3,1,3,1,0.1648,1383,6790,8173,1,0,0,3,1,0.1343,3,14,17
573,3,1,4,1,0.284813,1036,5825,6861,1,0,1,3,1,0.1343,0,5,5
574,3,1,5,1,0.152992,1259,5645,6904,1,0,2,3,1,0.194,3,7,10
575,3,1,6,0,0.15735,2234,4451,6685,1,0,5,3,1,0.2836,0,1,1
576,3,1,0,0,0.170396,2153,4444,6597,1,0,6,3,1,0.2836,0,8,8
577,3,1,1,1,0.153617,1040,6065,7105,1,0,7,3,1,0.2985,1,29,30
578,3,1,2,1,0.165425,968,6248,7216,1,0,8,3,1,0.2985,3,69,72
579,3,1,3,1,0.141179,1074,6506,7580,1,0,9,3,1,0.2985,3,55,58
580,3,1,4,1,0.129354,983,6278,7261,1,0,10,3,1,0.2836,2,26,28
581,3,1,5,1,0.215792,1328,5847,7175,1,0,11,3,1,0.3284,6,35,41
582,3,1,6,0,0.257458,2345,4479,6824,1,0,12,3,1,0.3284,7,41,48
583,3,1,0,0,0.290421,1707,3757,5464,1,0,13,3,1,0.3284,4,43,47
584,3,1,1,1,0.129354,1233,5780,7013,1,0,14,3,1,0.3582,0,36,36
585,3,1,2,1,0.116908,1278,5995,7273,1,0,15,3,1,0.4627,1,42,43
586,3,1,3,1,0.1107,1263,6271,7534,1,0,16,3,1,0.3284,1,35,36
587,3,1,4,1,0.1561,1196,6090,7286,1,0,17,3,1,0.3582,0,26,26
588,3,1,5,1,0.238813,1065,4721,5786,1,0,16,4,1,0.194,1,23,24
589,3,1,6,0,0.206479,2247,4052,6299,1,0,17,4,1,0.1045,2,82,84
590,3,1,0,0,0.122512,2182,4362,6544,1,0,18,4,1,0.0896,3,101,104
591,3,1,1,1,0.136212,1207,5676,6883,1,0,19,4,1,0.0896,3,76,79
592,3,1,2,1,0.169158,1128,5656,6784,1,0,20,4,1,0.0896,4,55,59
593,3,1,3,1,0.169771,1198,6149,7347,1,0,21,4,1,0.0896,2,36,38
594,3,1,4,1,0.141796,1338,6267,7605,1,0,22,4,1,0.0896,0,27,27
595,3,1,5,1,0.231354,1483,5665,7148,1,0,23,4,1,0.1642,0,16,16
596,3,1,6,0,0.177867,2827,5038,7865,1,0,0,5,1,0.1343,0,9,9
597,3,1,0,0,0.08645,1208,3341,4549,1,0,1,5,1,0.1343,1,2,3
598,3,1,1,1,0.129979,1026,5504,6530,1,0,2,5,1,0.1642,0,2,2
599,3,1,2,1,0.0727708,1081,5925,7006,1,0,3,5,1,0.1045,1,0,1
600,3,1,3,1,0.0702833,1094,6281,7375,1,0,5,5,1,0.1045,0,4,4
601,3,1,4,1,0.0845958,1363,6402,7765,1,0,6,5,1,0.1343,0,16,16
602,3,1,5,1,0.0721458,1325,6257,7582,1,0,7,5,1,0.0896,2,58,60
603,3,1,6,0,0.244408,1829,4224,6053,1,0,8,5,1,0.0896,2,155,157
604,3,1,0,0,0.228858,1483,3772,5255,1,0,9,5,1,0.0896,6,95,101
605,3,1,1,1,0.128733,989,5928,6917,1,0,10,5,1,0.1045,0,49,49
606,3,1,2,1,0.190925,935,6105,7040,1,0,11,5,1,0.1045,0,30,30
607,3,1,3,1,0.112562,1177,6520,7697,1,0,12,5,1,0.1045,1,28,29
608,3,1,4,1,0.0771167,1172,6541,7713,1,0,13,5,1,0.1045,0,31,31
609,3,1,5,1,0.168533,1433,5917,7350,1,0,14,5,1,0.0,2,36,38
610,3,1,6,0,0.113187,2352,3788,6140,1,0,15,5,1,0.0,1,40,41
611,3,1,0,0,0.0640708,2613,3197,5810,1,0,16,5,1,0.0,10,70,80
612,3,1,1,0,0.151121,1965,4069,6034,1,0,17,5,1,0.1343,2,147,149
613,3,1,2,1,0.236321,867,5997,6864,1,0,18,5,1,0.194,2,107,109
614,3,1,3,1,0.187808,832,6280,7112,1,0,19,5,1,0.1343,5,84,89
615,3,1,4,1,0.142421,611,5592,6203,1,0,20,5,1,0.194,1,61,62
616,3,1,5,1,0.171646,1045,6459,7504,1,0,21,5,1,0.1343,1,57,58
617,3,1,6,0,0.281104,1557,4419,5976,1,0,22,5,1,0.3582,0,26,26
618,3,1,0,0,0.224496,2570,5657,8227,1,0,23,5,1,0.2239,1,22,23
619,3,1,1,1,0.258713,1118,6407,7525,1,0,0,6,0,0.3582,2,26,28
620,3,1,2,1,0.0920542,1070,6697,7767,1,0,1,6,0,0.194,0,20,20
621,3,1,3,1,0.131846,1050,6820,7870,1,0,2,6,0,0.1642,0,15,15
622,3,1,4,1,0.0827208,1054,6750,7804,1,0,3,6,0,0.1343,3,5,8
623,3,1,5,1,0.103863,1379,6630,8009,1,0,4,6,0,0.1045,1,2,3
624,3,1,6,0,0.247521,3160,5554,8714,1,0,6,6,0,0.1343,0,2,2
625,3,1,0,0,0.0901833,2166,5167,7333,1,0,7,6,0,0.1045,1,4,5
626,3,1,1,1,0.151742,1022,5847,6869,1,0,8,6,0,0.1642,3,31,34
627,3,1,2,1,0.357587,371,3702,4073,1,0,9,6,0,0.0896,0,34,34
628,3,1,3,1,0.215175,788,6803,7591,1,0,10,6,0,0.1045,4,51,55
629,3,1,4,1,0.118167,939,6781,7720,1,0,11,6,0,0.1343,4,60,64
630,3,1,5,1,0.154229,1250,6917,8167,1,0,12,6,0,0.194,12,66,78
631,3,1,6,0,0.283583,2512,5883,8395,1,0,13,6,0,0.1642,9,56,65
632,4,1,0,0,0.223258,2454,5453,7907,1,0,14,6,0,0.1343,10,89,99
633,4,1,1,1,0.142404,1001,6435,7436,1,0,15,6,0,0.2537,22,98,120
634,4,1,2,1,0.236321,845,6693,7538,1,0,16,6,0,0.1642,19,88,107
635,4,1,3,1,0.2444,787,6946,7733,1,0,17,6,0,0.0,9,82,91
636,4,1,4,1,0.134342,751,6642,7393,1,0,18,6,0,0.1343,9,59,68
637,4,1,5,1,0.164179,1045,6370,7415,1,0,19,6,0,0.2537,6,52,58
638,4,1,6,0,0.227604,2589,5966,8555,1,0,20,6,0,0.0896,1,42,43
639,4,1,0,0,0.134958,2015,4874,6889,1,0,21,6,0,0.0896,1,35,36
640,4,1,1,1,0.0908042,763,6015,6778,1,0,22,6,0,0.0896,4,28,32
641,4,1,2,1,0.104475,315,4324,4639,1,0,23,6,0,0.0896,3,30,33
642,4,1,3,1,0.0665458,728,6844,7572,1,0,0,0,0,0.1045,0,33,33
643,4,1,4,1,0.117546,891,6437,7328,1,0,1,0,0,0.0,7,22,29
644,4,1,5,1,0.10635,1516,6640,8156,1,0,2,0,0,0.0,1,10,11
645,4,1,6,0,0.268025,3031,4934,7965,1,0,3,0,0,0.0,1,7,8
646,4,1,0,0,0.141162,781,2729,3510,1,0,4,0,0,0.0,0,1,1
647,4,1,1,0,0.189679,874,4604,5478,1,0,5,0,0,0.0,0,3,3
648,4,1,2,1,0.1903,601,5791,6392,1,0,7,0,0,0.0,0,3,3
649,4,1,3,1,0.187821,780,6911,7691,1,0,8,0,0,0.0,1,11,12
650,4,1,4,1,0.181596,834,6736,7570,1,0,9,0,0,0.0,4,34,38
651,4,1,5,1,0.235092,1060,6222,7282,1,0,10,0,0,0.0,7,57,64
652,4,1,6,0,0.146142,2252,4857,7109,1,0,11,0,0,0.0,9,50,59
653,4,1,0,0,0.278612,2080,4559,6639,1,0,12,0,0,0.1045,10,87,97
654,4,1,1,1,0.296037,760,5115,5875,1,0,13,0,0,0.1045,13,71,84
655,4,1,2,1,0.182221,922,6612,7534,1,0,14,0,0,0.0896,18,104,122
656,4,1,3,1,0.101371,979,6482,7461,1,0,15,0,0,0.0,14,95,109
657,4,1,4,1,0.236937,1008,6501,7509,1,0,16,0,0,0.0,19,104,123
658,4,1,5,1,0.134954,753,4671,5424,1,0,17,0,0,0.194,6,71,77
659,4,1,6,0,0.117537,2806,5284,8090,1,0,18,0,0,0.1642,8,57,65
660,4,1,0,0,0.166054,2132,4692,6824,1,0,19,0,0,0.194,9,46,55
661,4,1,1,1,0.0814833,830,6228,7058,1,0,20,0,0,0.1045,3,30,33
662,4,1,2,1,0.0945458,841,6625,7466,1,0,21,0,0,0.1642,3,25,28
663,4,1,3,1,0.0727792,795,6898,7693,1,0,22,0,0,0.194,2,19,21
664,4,1,4,1,0.124375,875,6484,7359,1,0,23,0,0,0.2836,5,16,21
665,4,1,5,1,0.132467,1182,6262,7444,1,0,0,1,1,0.2239,1,6,7
666,4,1,6,0,0.235692,2643,5209,7852,1,0,1,1,1,0.2537,2,5,7
667,4,1,0,0,0.398008,998,3461,4459,1,0,2,1,1,0.194,0,1,1
668,4,1,1,1,0.3582,2,20,22,1,0,3,1,1,0.194,0,2,2
669,4,1,2,1,0.213009,87,1009,1096,1,0,4,1,1,0.2239,0,2,2
670,4,1,3,1,0.166667,419,5147,5566,1,0,5,1,1,0.2836,0,8,8
671,4,1,4,1,0.157346,466,5520,5986,1,0,6,1,1,0.3284,0,37,37
672,4,1,5,1,0.266175,618,5229,5847,1,0,7,1,1,0.2836,1,71,72
673,4,1,6,0,0.270529,1029,4109,5138,1,0,8,1,1,0.2836,3,182,185
674,4,1,0,0,0.179108,1201,3906,5107,1,0,9,1,1,0.2985,0,112,112
675,4,1,1,1,0.236325,378,4881,5259,1,0,10,1,1,0.194,1,68,69
676,4,1,2,1,0.173513,466,5220,5686,1,0,11,1,1,0.194,2,46,48
677,4,1,3,1,0.304108,326,4709,5035,1,0,12,1,1,0.1045,6,62,68
678,4,1,4,1,0.347835,340,4975,5315,1,0,13,1,1,0.0,2,52,54
679,4,1,5,1,0.214558,709,5283,5992,1,0,14,1,1,0.1343,1,85,86
680,4,1,6,0,0.0578458,2090,4446,6536,1,0,15,1,1,0.1343,3,41,44
681,4,1,0,0,0.1275,2290,4562,6852,1,0,16,1,1,0.194,3,83,86
682,4,1,1,0,0.173517,1097,5172,6269,1,0,17,1,1,0.194,6,155,161
683,4,1,2,1,0.342046,327,3767,4094,1,0,18,1,1,0.2239,3,153,156
684,4,1,3,1,0.199625,373,5122,5495,1,0,19,1,1,0.1045,3,108,111
685,4,1,4,1,0.152987,320,5125,5445,1,0,20,1,1,0.1642,0,78,78
686,4,1,5,1,0.171025,484,5214,5698,1,0,21,1,1,0.0896,3,53,56
687,4,1,6,0,0.179729,1313,4316,5629,1,0,22,1,1,0.1045,0,34,34
688,4,1,0,0,0.227612,922,3747,4669,1,0,23,1,1,0.0896,2,15,17
689,4,1,1,1,0.235067,449,5050,5499,1,0,0,2,1,0.1045,2,6,8
690,4,1,2,1,0.082725,534,5100,5634,1,0,1,2,1,0.1045,0,3,3
691,4,1,3,1,0.103246,615,4531,5146,1,0,2,2,1,0.0,0,2,2
692,4,1,4,0,0.0528708,955,1470,2425,1,0,3,2,1,0.0,0,2,2
693,4,1,5,1,0.148021,1603,2307,3910,1,0,5,2,1,0.0,0,3,3
694,4,1,6,0,0.376871,532,1745,2277,1,0,6,2,1,0.0,0,22,22
695,4,1,0,0,0.1505,309,2115,2424,1,0,7,2,1,0.0,0,52,52
696,4,1,1,1,0.04665,337,4750,5087,1,0,8,2,1,0.0,3,132,135
697,4,1,2,1,0.237562,123,3836,3959,1,0,9,2,1,0.0,2,114,116
698,4,1,3,1,0.210821,198,5062,5260,1,0,10,2,1,0.0,0,47,47
699,4,1,4,1,0.115522,243,5080,5323,1,0,11,2,1,0.0,2,49,51
700,4,1,5,1,0.0584708,362,5306,5668,1,0,12,2,1,0.0,2,53,55
701,4,1,6,0,0.0597042,951,4240,5191,1,0,13,2,1,0.0,3,49,52
702,4,1,0,0,0.124379,892,3757,4649,1,0,14,2,1,0.0896,5,49,54
703,4,1,1,1,0.0827208,555,5679,6234,1,0,15,2,1,0.0,7,45,52
704,4,1,2,1,0.174129,551,6055,6606,1,0,16,2,1,0.1343,3,61,64
705,4,1,3,1,0.324021,331,5398,5729,1,0,17,2,1,0.0,4,172,176
706,4,1,4,1,0.174754,340,5035,5375,1,0,18,2,1,0.1045,3,165,168
707,4,1,5,1,0.1306,349,4659,5008,1,0,19,2,1,0.1343,3,105,108
708,4,1,6,0,0.101379,1153,4429,5582,1,0,20,2,1,0.1343,5,69,74
709,4,1,0,0,0.157975,441,2787,3228,1,0,21,2,1,0.1343,0,64,64
710,4,1,1,1,0.190308,329,4841,5170,1,0,22,2,1,0.0896,2,34,36
711,4,1,2,1,0.296037,282,5219,5501,1,0,23,2,1,0.194,1,15,16
712,4,1,3,1,0.162937,310,5009,5319,1,0,0,3,1,0.1045,0,2,2
713,4,1,4,1,0.174129,425,5107,5532,1,0,1,3,1,0.194,0,3,3
714,4,1,5,1,0.131229,429,5182,5611,1,0,2,3,1,0.1343,4,0,4
715,4,1,6,0,0.10635,767,4280,5047,1,0,3,3,1,0.1343,0,1,1
716,4,1,0,0,0.100742,538,3248,3786,1,0,4,3,1,0.2836,0,1,1
717,4,1,1,1,0.0982583,212,4373,4585,1,0,5,3,1,0.1045,0,3,3
718,4,1,2,1,0.221404,433,5124,5557,1,0,6,3,1,0.1045,1,17,18
719,4,1,3,1,0.184092,333,4934,5267,1,0,7,3,1,0.2239,1,48,49
720,4,1,4,1,0.132463,314,3814,4128,1,0,8,3,1,0.2239,1,154,155
721,1,1,5,1,0.374383,221,3402,3623,1,0,9,3,1,0.0896,4,119,123
722,1,1,6,0,0.407346,205,1544,1749,1,0,10,3,1,0.0,2,59,61
723,1,1,0,0,0.133083,408,1379,1787,1,0,11,3,1,0.194,5,47,52
724,1,1,1,1,0.0772304,174,746,920,1,0,12,3,1,0.2239,3,61,64
725,1,1,2,0,0.168726,440,573,1013,1,0,13,3,1,0.1642,1,74,75
726,1,1,3,1,0.316546,9,432,441,1,0,14,3,1,0.3881,2,61,63
727,1,1,4,1,0.350133,247,1867,2114,1,0,15,3,1,0.3284,10,66,76
728,1,1,5,1,0.155471,644,2451,3095,1,0,16,3,1,0.2985,8,95,103
729,1,1,6,0,0.124383,159,1182,1341,1,0,17,3,1,0.5224,7,183,190
730,1,1,0,0,0.350754,364,1432,1796,1,0,18,3,1,0.5522,7,175,182
731,1,1,1,1,0.154846,439,2290,2729,1,0,19,3,1,0.4925,3,88,91
